15
10
2
# # # # # # # # # # # # # # # 
# . . . . . . . . . . . . . # 
S . . . . . . . . . . . . . E 
# . . . . . . . . . . . . . #
# . . . . . . . . . . . . . #
# . . . . . . . . . . . . . #
# . . . . . . . . . . . . . #
# . . . . . . . M . . . M . #
# . . . . . . . . . . . . . # 
# # # # # # # # # # # # # # # 
