5
5
. . . . S 
. . . . . 
. . . . . 
. . . # . 
E . . . . 
