5
5
. . . . S 
. M . . . 
. . . . . 
. . . M . 
E . . . . 
